Абаза 	Республика Хакасия 	19
Абакан 	Республика Хакасия 	19
Абдулино 	Оренбургская область 	56
Абинск 	Краснодарский край 	23
Агидель 	Республика Башкортостан 	02
Агрыз 	Республика Татарстан 	16
Адыгейск 	Республика Адыгея 	01
Азнакаево 	Республика Татарстан 	16
Азов 	Ростовская область 	61
Ак-Довурак 	Республика Тыва 	17
Аксай 	Ростовская область 	61
Аксубаево (ПГТ) 	Республика Татарстан 	16
Актюбинский (ПГТ) 	Республика Татарстан 	16
Алагир 	Республика Северная Осетия - Алания 	15
Алапаевск 	Свердловская область 	66
Алатырь 	Чувашская Республика 	21
Алдан 	Республика Саха (Якутия) 	14
Алейск 	Алтайский край 	22
Александров 	Владимирская область 	33
Александровск 	Пермский край 	59
Александровск-Сахалинский 	Сахалинская область 	65
Алексеевка 	Белгородская область 	31
Алексеевское (ПГТ) 	Республика Татарстан 	16
Алексин 	Тульская область 	71
Алзамай 	Иркутская область 	38
Али-Бердуковский 	Республика Карачаево-Черкессия 	09
Алтухово 	Брянская область 	32
Алупка 	Автономная Республика Крым 	82
Алушта 	Автономная Республика Крым 	82
Альметьевск 	Республика Татарстан 	16
Амурск 	Хабаровский край 	27
Анадырь 	Чукотский автономный округ 	87
Анапа 	Краснодарский край 	23
Ангарск 	Иркутская область 	38
Андреаполь 	Тверская область 	69
Анжеро-Судженск 	Кемеровская область 	42
Анива 	Сахалинская область 	65
Апастово (ПГТ) 	Республика Татарстан 	16
Апатиты 	Мурманская область 	51
Апрелевка 	Московская область 	50
Апшеронск 	Краснодарский край 	23
Арамиль 	Свердловская область 	66
Аргун 	Чеченская Республика 	20
Ардатов 	Республика Мордовия 	13
Ардон 	Республика Северная Осетия - Алания 	15
Арзамас 	Нижегородская область 	52
Аркадак 	Саратовская область 	64
Армавир 	Краснодарский край 	23
Армянск 	Автономная Республика Крым 	82
Арсеньев 	Приморский край 	25
Арск 	Республика Татарстан 	16
Артём 	Приморский край 	25
Артёмовск 	Красноярский край 	24
Артёмовский 	Свердловская область 	66
Архангельск 	Архангельская область 	29
Архонская 	Республика Северная Осетия - Алания 	15
Асбест 	Свердловская область 	66
Асино 	Томская область 	70
Астрахань 	Астраханская область 	30
Аткарск 	Саратовская область 	64
Ахтубинск 	Астраханская область 	30
Ачинск 	Красноярский край 	24
Аша 	Челябинская область 	74
Б
Бабаево 	Вологодская область 	35
Бабушкин 	Ресупблика Бурятия 	03
Бавлы 	Республика Татарстан 	16
Багратионовск 	Калининградская область 	39
Байкальск 	Иркутская область 	38
Баймак 	Республика Башкортостан 	02
Бакал 	Челябинская область 	74
Баксан 	Кабардино-Балкарская Республика 	07
Балабаново 	Калужская область 	40
Балаково 	Саратовская область 	64
Балахна 	Нижегородская область 	52
Балашиха 	Московская область 	50
Балашов 	Саратовская область 	64
Балей 	Забайкальский край 	75
Балтаси (ПГТ) 	Республика Татарстан 	16
Балтийск 	Калининградская область 	39
Барабинск 	Новосибирская область 	54
Барнаул 	Алтайский край 	22
Барыш 	Ульяновская область 	73
Батайск 	Ростовская область 	61
Бахчисарай 	Автономная Республика Крым 	82
Башмаково (ПГТ) 	Пензенская область 	58
Бежаницы 	Псковская область 	60
Бежецк 	Тверская область 	69
Беково (ПГТ) 	Пензенская область 	58
Белая Берёзка 	Брянская область 	32
Белая Калитва 	Ростовская область 	61
Белая Холуница 	Кировская область 	43
Белгород 	Белгородская область 	31
Белебей 	Республика Башкортостан 	02
Белёв 	Тульская область 	71
Белинский 	Пензенская область 	58
Белово 	Кемеровская область 	42
Белогорск 	Амурская область 	28
Белогорск 	Автономная Республика Крым 	82
Белозерск 	Вологодская область 	35
Белокуриха 	Алтайский край 	22
Беломорск 	Республика Карелия 	10
Белорецк 	Республика Башкортостан 	02
Белореченск 	Краснодарский край 	23
Белоусово 	Калужская область 	40
Белоярский 	ХМАО ЮГРА 	86
Белушья Губа 	Архангельская область 	29
Белые Берега 	Брянская область 	32
Белый 	Тверская область 	69
Бердск 	Новосибирская область 	54
Березник 	Архангельская область 	29
Березники 	Пермский край 	59
Берёзовский 	Кемеровская область 	42
Берёзовский 	Свердловская область 	66
Беслан 	Республика Северная Осетия - Алания 	15
Бийск 	Алтайский край 	22
Бикин 	Хабаровский край 	27
Билибино 	Чукотский автономный округ 	87
Биробиджан 	Еврейская автономная область 	79
Бирск 	Республика Башкортостан 	02
Бирюсинск 	Иркутская область 	38
Бирюч 	Белгородская область 	31
Благовещенск 	Республика Башкортостан 	02
Благовещенск 	Амурская область 	28
Благодарный 	Ставропольский край 	26
Бобров 	Воронежская область 	36
Богатые Сабы (ПГТ) 	Республика Татарстан 	16
Богданович 	Свердловская область 	66
Богородицк 	Тульская область 	71
Богородск 	Нижегородская область 	52
Боготол 	Красноярский край 	24
Богучар 	Воронежская область 	36
Бодайбо 	Иркутская область 	38
Бокситогорск 	Ленинградская область 	47
Болгар 	Республика Татарстан 	16
Бологое 	Тверская область 	69
Болотное 	Новосибирская область 	54
Болохово 	Тульская область 	71
Болхов 	Орловская область 	57
Большое Полпино 	Брянская область 	32
Большой Камень 	Приморский край 	25
Бор 	Нижегородская область 	52
Борзя 	Забайкальский край 	75
Борисоглебск 	Воронежская область 	36
Боровичи 	Новгородская область 	53
Боровск 	Калужская область 	40
Бородино 	Красноярский край 	24
Братск 	Иркутская область 	38
Бронницы 	Московская область 	50
Брянск 	Брянская область 	32
Бугульма 	Республика Татарстан 	16
Бугуруслан 	Оренбургская область 	56
Будённовск 	Ставропольский край 	26
Бузулук 	Оренбургская область 	56
Буинск 	Республика Татарстан 	16
Буй 	Костромская область 	44
Буйнакск 	Республика Дагестан 	05
Бутурлиновка 	Воронежская область 	36
Бытошь 	Брянская область 	32
В
Валдай 	Новгородская область 	53
Валуйки 	Белгородская область 	31
Васильево (ПГТ) 	Республика Татарстан 	16
Велиж 	Смоленская область 	67
Великие Луки 	Псковская область 	60
Великий Новгород 	Новгородская область 	53
Великий Устюг 	Вологодская область 	35
Вельск 	Архангельская область 	29
Венёв 	Тульская область 	71
Верещагино 	Пермский край 	59
Верея 	Московская область 	50
Верхнеднепровский (ПГТ) 	Смоленская область 	67
Верхнеуральск 	Челябинская область 	74
Верхний Тагил 	Свердловская область 	66
Верхний Уфалей 	Челябинская область 	74
Верхняя Пышма 	Свердловская область 	66
Верхняя Салда 	Свердловская область 	66
Верхняя Тура 	Свердловская область 	66
Верхозим (ПГТ) 	Пензенская область 	58
Верхотурье 	Свердловская область 	66
Верхоянск 	Республика Саха (Якутия) 	14
Весьегонск 	Тверская область 	69
Ветлуга 	Нижегородская область 	52
Видное 	Московская область 	50
Вилюйск 	Республика Саха (Якутия) 	14
Вилючинск 	Камчатский край 	41
Вихоревка 	Иркутская область 	38
Вичуга 	Ивановская область 	37
Владивосток 	Приморский край 	25
Владикавказ 	Республика Северная Осетия - Алания 	15
Владимир 	Владимирская область 	33
Волгоград 	Волгоградская область 	34
Волгодонск 	Ростовская область 	61
Волгореченск 	Костромская область 	44
Волжск 	Республика Марий Эл 	12
Волжский 	Волгоградская область 	34
Вологда 	Вологодская область 	35
Володарск 	Нижегородская область 	52
Волоколамск 	Московская область 	50
Волосово 	Ленинградская область 	47
Волхов 	Ленинградская область 	47
Волчанск 	Свердловская область 	66
Вольск 	Саратовская область 	64
Воркута 	Республика Коми 	11
Воронеж 	Воронежская область 	36
Ворсма 	Нижегородская область 	52
Воскресенск 	Московская область 	50
Воткинск 	Удмуртская Республика 	18
Всеволожск 	Ленинградская область 	47
Вуктыл 	Республика Коми 	11
Выборг 	Ленинградская область 	47
Выгоничи 	Брянская область 	32
Выкса 	Нижегородская область 	52
Высоковск 	Московская область 	50
Высоцк 	Ленинградская область 	47
Вытегра 	Вологодская область 	35
Вычегодский 	Архангельская область 	29
Вышков 	Брянская область 	32
Вышний Волочёк 	Тверская область 	69
Вяземский 	Хабаровский край 	27
Вязники 	Владимирская область 	33
Вязьма 	Смоленская область 	67
Вятские Поляны 	Кировская область 	43
Г
Гаврилов Посад 	Ивановская область 	37
Гаврилов-Ям 	Ярославская область 	76
Гагарин 	Смоленская область 	67
Гаджиево 	Мурманская область 	51
Гай 	Оренбургская область 	56
Галич 	Костромская область 	44
Гаспра 	Автономная Республика Крым 	82
Гатчина 	Ленинградская область 	47
Гвардейск 	Калининградская область 	39
Гвардейское 	Автономная Республика Крым 	82
Гдов 	Псковская область 	60
Геленджик 	Краснодарский край 	23
Георгиевск 	Ставропольский край 	26
Гизель 	Республика Северная Осетия - Алания 	15
Глазов 	Удмуртская Республика 	18
Голицыно 	Московская область 	50
Голынки (ПГТ) 	Смоленская область 	67
Горагорск (ПГТ) 	Чеченская Республика 	20
Горбатов 	Нижегородская область 	52
Горно-Алтайск 	Ресупблика Алтай 	04
Горнозаводск 	Пермский край 	59
Горняк 	Алтайский край 	22
Городец 	Нижегородская область 	52
Городище 	Пензенская область 	58
Городовиковск 	Республика Калмыкия 	08
Гороховец 	Владимирская область 	33
Горячий Ключ 	Краснодарский край 	23
Грайворон 	Белгородская область 	31
Гремячинск 	Пермский край 	59
Грозный 	Чеченская Республика 	20
Грязи 	Липецкая область 	48
Грязовец 	Вологодская область 	35
Губаха 	Пермский край 	59
Губкин 	Белгородская область 	31
Губкинский 	Ямало-Ненецкий автономный округ 	89
Гудермес 	Чеченская Республика 	20
Гуково 	Ростовская область 	61
Гулькевичи 	Краснодарский край 	23
Гурьевск 	Калининградская область 	39
Гурьевск 	Кемеровская область 	42
Гусев 	Калининградская область 	39
Гусиноозёрск 	Ресупблика Бурятия 	03
Гусь-Хрустальный 	Владимирская область 	33
Д
Давлеканово 	Республика Башкортостан 	02
Дагестанские Огни 	Республика Дагестан 	05
Далматово 	Курганская область 	45
Дальнегорск 	Приморский край 	25
Дальнереченск 	Приморский край 	25
Данилов 	Ярославская область 	76
Данков 	Липецкая область 	48
Дегтярск 	Свердловская область 	66
Дедовичи 	Псковская область 	60
Дедовск 	Московская область 	50
Демидов 	Смоленская область 	67
Дербент 	Республика Дагестан 	05
Десногорск 	Смоленская область 	67
Джалиль (ПГТ) 	Республика Татарстан 	16
Джанкой 	Автономная Республика Крым 	82
Дзержинск 	Нижегородская область 	52
Дзержинский 	Московская область 	50
Дивногорск 	Красноярский край 	24
Дигора 	Республика Северная Осетия - Алания 	15
Димитровград 	Ульяновская область 	73
Дмитриев 	Курская область 	46
Дмитриевка 	Тамбовская область 	68
Дмитров 	Московская область 	50
Дмитровск 	Орловская область 	57
Дно 	Псковская область 	60
Добрянка 	Пермский край 	59
Долгопрудный 	Московская область 	50
Долинск 	Сахалинская область 	65
Домодедово 	Московская область 	50
Донецк 	Ростовская область 	61
Донской 	Тульская область 	71
Дорогобуж 	Смоленская область 	67
Дрезна 	Московская область 	50
Дубна 	Московская область 	50
Дубовка 	Волгоградская область 	34
Дубровка 	Брянская область 	32
Дудинка 	Красноярский край 	24
Духовщина 	Смоленская область 	67
Дюртюли 	Республика Башкортостан 	02
Дятьково 	Брянская область 	32
Е
Евлашево (ПГТ) 	Пензенская область 	58
Евпатория 	Автономная Республика Крым 	82
Егорьевск 	Московская область 	50
Ейск 	Краснодарский край 	23
Екатеринбург 	Свердловская область 	66
Елабуга 	Республика Татарстан 	16
Елец 	Липецкая область 	48
Елизово 	Камчатский край 	41
Ельня 	Смоленская область 	67
Еманжелинск 	Челябинская область 	74
Емва 	Республика Коми 	11
Емца 	Архангельская область 	29
Енисейск 	Красноярский край 	24
Ермолино 	Калужская область 	40
Ершов 	Саратовская область 	64
Ессентуки 	Ставропольский край 	26
Ефремов 	Тульская область 	71
Ж
Железноводск 	Ставропольский край 	26
Железногорск 	Красноярский край 	24
Железногорск 	Курская область 	46
Железногорск-Илимский 	Иркутская область 	38
Жердевка 	Тамбовская область 	68
Жигулёвск 	Самарская область 	63
Жиздра 	Калужская область 	40
Жирновск 	Волгоградская область 	34
Жуков 	Калужская область 	40
Жуковка 	Брянская область 	32
Жуковский 	Московская область 	50
З
Завитинск 	Амурская область 	28
Заводоуковск 	Тюменская область 	72
Заводской 	Республика Северная Осетия - Алания 	15
Заволжск 	Ивановская область 	37
Заволжье 	Нижегородская область 	52
Задонск 	Липецкая область 	48
Заинск 	Республика Татарстан 	16
Закаменск 	Ресупблика Бурятия 	03
Заозёрный 	Красноярский край 	24
Заозёрск 	Мурманская область 	51
Западная Двина 	Тверская область 	69
Заплюсье 	Псковская область 	60
Заполярный 	Мурманская область 	51
Зарайск 	Московская область 	50
Заречный 	Пензенская область 	58
Заречный 	Свердловская область 	66
Заринск 	Алтайский край 	22
Звенигово 	Республика Марий Эл 	12
Звенигород 	Московская область 	50
Зверево 	Ростовская область 	61
Зеленогорск 	Красноярский край 	24
Зеленоградск 	Калининградская область 	39
Зеленодольск 	Республика Татарстан 	16
Зеленокумск 	Ставропольский край 	26
Зеленчукская 	Республика Карачаево-Черкессия 	09
Земетчино (ПГТ) 	Пензенская область 	58
Зерноград 	Ростовская область 	61
Зея 	Амурская область 	28
Зима 	Иркутская область 	38
Златоуст 	Челябинская область 	74
Злынка 	Брянская область 	32
Змеиногорск 	Алтайский край 	22
Змейская 	Республика Северная Осетия - Алания 	15
Знаменка 	Тамбовская область 	68
Знаменск 	Астраханская область 	30
Золотарёвка (ПГТ) 	Пензенская область 	58
Зубцов 	Тверская область 	69
Зуевка 	Кировская область 	43
И
Ивангород 	Ленинградская область 	47
Иваново 	Ивановская область 	37
Ивантеевка 	Московская область 	50
Ивдель 	Свердловская область 	66
Ивот 	Брянская область 	32
Игарка 	Красноярский край 	24
Идрица 	Псковская область 	60
Ижевск 	Удмуртская Республика 	18
Избербаш 	Республика Дагестан 	05
Изобильный 	Ставропольский край 	26
Иланский 	Красноярский край 	24
Инжавино 	Тамбовская область 	68
Инза 	Ульяновская область 	73
Инкерман 	Автономная Республика Крым 	82
Иннополис 	Республика Татарстан 	16
Инсар 	Республика Мордовия 	13
Инта 	Республика Коми 	11
Ипатово 	Ставропольский край 	26
Ирбит 	Свердловская область 	66
Иркутск 	Иркутская область 	38
Исилькуль 	Омская область 	55
Искитим 	Новосибирская область 	54
Исса (ПГТ) 	Пензенская область 	58
Истра 	Московская область 	50
Ишим 	Тюменская область 	72
Ишимбай 	Республика Башкортостан 	02
Й
Йошкар-Ола 	Республика Марий Эл 	12
К
Кадников 	Вологодская область 	35
Казань 	Республика Татарстан 	16
Калач 	Воронежская область 	36
Калачинск 	Омская область 	55
Калач-на-Дону 	Волгоградская область 	34
Калининград 	Калининградская область 	39
Калининск 	Саратовская область 	64
Калтан 	Кемеровская область 	42
Калуга 	Калужская область 	40
Калязин 	Тверская область 	69
Камбарка 	Удмуртская Республика 	18
Камбилеевское 	Республика Северная Осетия - Алания 	15
Каменка 	Архангельская область 	29
Каменка 	Пензенская область 	58
Каменногорск 	Ленинградская область 	47
Каменск-Уральский 	Свердловская область 	66
Каменск-Шахтинский 	Ростовская область 	61
Камень-на-Оби 	Алтайский край 	22
Камешково 	Владимирская область 	33
Камские Поляны (ПГТ) 	Республика Татарстан 	16
Камское Устье (ПГТ) 	Республика Татарстан 	16
Камызяк 	Астраханская область 	30
Камышин 	Волгоградская область 	34
Камышлов 	Свердловская область 	66
Канаш 	Чувашская Республика 	21
Кандалакша 	Мурманская область 	51
Канск 	Красноярский край 	24
Карабаново 	Владимирская область 	33
Карабаш 	Челябинская область 	74
Карабаш (ПГТ) 	Республика Татарстан 	16
Карабулак 	Республика Ингушетия 	06
Карасук 	Новосибирская область 	54
Карачаевск 	Республика Карачаево-Черкессия 	09
Карачев 	Брянская область 	32
Каргат 	Новосибирская область 	54
Каргополь 	Архангельская область 	29
Кардоникская 	Республика Карачаево-Черкессия 	09
Кардымово (ПГТ) 	Смоленская область 	67
Карпинск 	Свердловская область 	66
Карталы 	Челябинская область 	74
Касимов 	Рязанская область 	62
Касли 	Челябинская область 	74
Каспийск 	Республика Дагестан 	05
Катав-Ивановск 	Челябинская область 	74
Катайск 	Курганская область 	45
Качканар 	Свердловская область 	66
Кашин 	Тверская область 	69
Кашира 	Московская область 	50
Кедровый 	Томская область 	70
Кемерово 	Кемеровская область 	42
Кемь 	Республика Карелия 	10
Керчь 	Автономная Республика Крым 	82
Кизел 	Пермский край 	59
Кизилюрт 	Республика Дагестан 	05
Кизляр 	Республика Дагестан 	05
Кизляр 	Республика Северная Осетия - Алания 	15
Кимовск 	Тульская область 	71
Кимры 	Тверская область 	69
Кингисепп 	Ленинградская область 	47
Кинель 	Самарская область 	63
Кинешма 	Ивановская область 	37
Киреевск 	Тульская область 	71
Киренск 	Иркутская область 	38
Киржач 	Владимирская область 	33
Кириллов 	Вологодская область 	35
Кириши 	Ленинградская область 	47
Киров 	Калужская область 	40
Киров 	Кировская область 	43
Кировград 	Свердловская область 	66
Кирово-Чепецк 	Кировская область 	43
Кировск 	Ленинградская область 	47
Кировск 	Мурманская область 	51
Кирс 	Кировская область 	43
Кирсанов 	Тамбовская область 	68
Киселёвск 	Кемеровская область 	42
Кисловодск 	Ставропольский край 	26
Клетня 	Брянская область 	32
Климово 	Брянская область 	32
Клин 	Московская область 	50
Клинцы 	Брянская область 	32
Княгинино 	Нижегородская область 	52
Ковдор 	Мурманская область 	51
Ковров 	Владимирская область 	33
Ковылкино 	Республика Мордовия 	13
Когалым 	ХМАО ЮГРА 	86
Кодинск 	Красноярский край 	24
Козельск 	Калужская область 	40
Козловка 	Чувашская Республика 	21
Козьмодемьянск 	Республика Марий Эл 	12
Кокоревка 	Брянская область 	32
Кола 	Мурманская область 	51
Кологрив 	Костромская область 	44
Коломна 	Московская область 	50
Колпашево 	Томская область 	70
Колышлей (ПГТ) 	Пензенская область 	58
Кольчугино 	Владимирская область 	33
Комаричи 	Брянская область 	32
Коммунар 	Ленинградская область 	47
Комсомольск 	Ивановская область 	37
Комсомольск-на-Амуре 	Хабаровский край 	27
Конаково 	Тверская область 	69
Кондопога 	Республика Карелия 	10
Кондрово 	Калужская область 	40
Коноша 	Архангельская область 	29
Константиновск 	Ростовская область 	61
Копейск 	Челябинская область 	74
Кораблино 	Рязанская область 	62
Кореновск 	Краснодарский край 	23
Коркино 	Челябинская область 	74
Королёв 	Московская область 	50
Короча 	Белгородская область 	31
Корсаков 	Сахалинская область 	65
Коряжма 	Архангельская область 	29
Костерёво 	Владимирская область 	33
Костомукша 	Республика Карелия 	10
Кострома 	Костромская область 	44
Котельники 	Московская область 	50
Котельниково 	Волгоградская область 	34
Котельнич 	Кировская область 	43
Котлас 	Архангельская область 	29
Котово 	Волгоградская область 	34
Котовск 	Тамбовская область 	68
Кохма 	Ивановская область 	37
Красавино 	Вологодская область 	35
Красная Гора 	Брянская область 	32
Красная Горбатка (ПГТ) 	Владимирская область 	33
Красноармейск 	Московская область 	50
Красноармейск 	Саратовская область 	64
Красновишерск 	Пермский край 	59
Красногвардейское 	Автономная Республика Крым 	82
Красногородск 	Псковская область 	60
Красногорск 	Московская область 	50
Краснодар 	Краснодарский край 	23
Краснозаводск 	Московская область 	50
Краснознаменск 	Калининградская область 	39
Краснознаменск 	Московская область 	50
Краснокаменск 	Забайкальский край 	75
Краснокамск 	Пермский край 	59
Красноперекопск 	Автономная Республика Крым 	82
Краснослободск 	Республика Мордовия 	13
Краснослободск 	Волгоградская область 	34
Краснотурьинск 	Свердловская область 	66
Красноуральск 	Свердловская область 	66
Красноуфимск 	Свердловская область 	66
Красноярск 	Красноярский край 	24
Красный (ПГТ) 	Смоленская область 	67
Красный Кут 	Саратовская область 	64
Красный Луч 	Псковская область 	60
Красный Сулин 	Ростовская область 	61
Красный Холм 	Тверская область 	69
Кремёнки 	Калужская область 	40
Кропоткин 	Краснодарский край 	23
Крымск 	Краснодарский край 	23
Кстово 	Нижегородская область 	52
Кубинка 	Московская область 	50
Кувандык 	Оренбургская область 	56
Кувшиново 	Тверская область 	69
Кудымкар 	Пермский край 	59
Кузнецк 	Пензенская область 	58
Куйбышев 	Новосибирская область 	54
Куйбышевский Затон (ПГТ) 	Республика Татарстан 	16
Кукмор 	Республика Татарстан 	16
Кулебаки 	Нижегородская область 	52
Кулой 	Архангельская область 	29
Кумертау 	Республика Башкортостан 	02
Кумыш 	Республика Карачаево-Черкессия 	09
Кунгур 	Пермский край 	59
Кунья 	Псковская область 	60
Купино 	Новосибирская область 	54
Курган 	Курганская область 	45
Курганинск 	Краснодарский край 	23
Курджиново 	Республика Карачаево-Черкессия 	09
Курильск 	Сахалинская область 	65
Курлово 	Владимирская область 	33
Куровское 	Московская область 	50
Курск 	Курская область 	46
Куртамыш 	Курганская область 	45
Курчатов 	Курская область 	46
Куса 	Челябинская область 	74
Кушва 	Свердловская область 	66
Кызыл 	Республика Тыва 	17
Кыштым 	Челябинская область 	74
Кяхта 	Ресупблика Бурятия 	03
Л
Лабинск 	Краснодарский край 	23
Лабытнанги 	Ямало-Ненецкий автономный округ 	89
Лагань 	Республика Калмыкия 	08
Ладушкин 	Калининградская область 	39
Лаишево 	Республика Татарстан 	16
Лакинск 	Владимирская область 	33
Лангепас 	ХМАО ЮГРА 	86
Лахденпохья 	Республика Карелия 	10
Лебедянь 	Липецкая область 	48
Лениногорск 	Республика Татарстан 	16
Ленинск 	Волгоградская область 	34
Ленинск-Кузнецкий 	Кемеровская область 	42
Ленск 	Республика Саха (Якутия) 	14
Лермонтов 	Ставропольский край 	26
Лесной 	Свердловская область 	66
Лесозаводск 	Приморский край 	25
Лесосибирск 	Красноярский край 	24
Ливны 	Орловская область 	57
Ликино-Дулёво 	Московская область 	50
Липецк 	Липецкая область 	48
Липки 	Тульская область 	71
Лиски 	Воронежская область 	36
Лихославль 	Тверская область 	69
Лобня 	Московская область 	50
Лодейное Поле 	Ленинградская область 	47
Локня 	Псковская область 	60
Локоть 	Брянская область 	32
Лосино-Петровский 	Московская область 	50
Луга 	Ленинградская область 	47
Луза 	Кировская область 	43
Луковская 	Республика Северная Осетия - Алания 	15
Лукоянов 	Нижегородская область 	52
Лунино (ПГТ) 	Пензенская область 	58
Луховицы 	Московская область 	50
Лысково 	Нижегородская область 	52
Лысьва 	Пермский край 	59
Лыткарино 	Московская область 	50
Льгов 	Курская область 	46
Любань 	Ленинградская область 	47
Люберцы 	Московская область 	50
Любим 	Ярославская область 	76
Любохна 	Брянская область 	32
Людиново 	Калужская область 	40
Лянтор 	ХМАО ЮГРА 	86
М
Магадан 	Магаданская область 	49
Магас 	Республика Ингушетия 	06
Магнитогорск 	Челябинская область 	74
Майкоп 	Республика Адыгея 	01
Майский 	Кабардино-Балкарская Республика 	07
Майское 	Республика Северная Осетия - Алания 	15
Макаров 	Сахалинская область 	65
Макарьев 	Костромская область 	44
Макушино 	Курганская область 	45
Малая Вишера 	Новгородская область 	53
Малгобек 	Республика Ингушетия 	06
Малмыж 	Кировская область 	43
Малоархангельск 	Орловская область 	57
Малошуйка 	Архангельская область 	29
Малоярославец 	Калужская область 	40
Мамадыш 	Республика Татарстан 	16
Мамоново 	Калининградская область 	39
Мантурово 	Костромская область 	44
Мариинск 	Кемеровская область 	42
Мариинский Посад 	Чувашская Республика 	21
Маркс 	Саратовская область 	64
Махачкала 	Республика Дагестан 	05
Мглин 	Брянская область 	32
Мегион 	ХМАО ЮГРА 	86
Медвежьегорск 	Республика Карелия 	10
Медногорск 	Оренбургская область 	56
Медногорский 	Республика Карачаево-Черкессия 	09
Медынь 	Калужская область 	40
Межгорье 	Республика Башкортостан 	02
Междуреченск 	Кемеровская область 	42
Мезень 	Архангельская область 	29
Меленки 	Владимирская область 	33
Мелеуз 	Республика Башкортостан 	02
Менделеевск 	Республика Татарстан 	16
Мензелинск 	Республика Татарстан 	16
Мещовск 	Калужская область 	40
Миасс 	Челябинская область 	74
Микунь 	Республика Коми 	11
Миллерово 	Ростовская область 	61
Минеральные Воды 	Ставропольский край 	26
Минусинск 	Красноярский край 	24
Миньяр 	Челябинская область 	74
Мирный 	Республика Саха (Якутия) 	14
Мирный 	Архангельская область 	29
Михайлов 	Рязанская область 	62
Михайловка 	Волгоградская область 	34
Михайловск 	Ставропольский край 	26
Михайловск 	Свердловская область 	66
Михайловское 	Республика Северная Осетия - Алания 	15
Мичуринск 	Тамбовская область 	68
Могоча 	Забайкальский край 	75
Можайск 	Московская область 	50
Можга 	Удмуртская Республика 	18
Моздок 	Республика Северная Осетия - Алания 	15
Мокшан (ПГТ) 	Пензенская область 	58
Монастырщина (ПГТ) 	Смоленская область 	67
Мончегорск 	Мурманская область 	51
Мордово 	Тамбовская область 	68
Морозовск 	Ростовская область 	61
Моршанск 	Тамбовская область 	68
Мосальск 	Калужская область 	40
Москва 	Город Москва 	77
Муравленко 	Ямало-Ненецкий автономный округ 	89
Мураши 	Кировская область 	43
Мурманск 	Мурманская область 	51
Муром 	Владимирская область 	33
Мучкапский 	Тамбовская область 	68
Мценск 	Орловская область 	57
Мыски 	Кемеровская область 	42
Мытищи 	Московская область 	50
Мышкин 	Ярославская область 	76
Н
Набережные Челны 	Республика Татарстан 	16
Навашино 	Нижегородская область 	52
Навля 	Брянская область 	32
Наволоки 	Ивановская область 	37
Надым 	Ямало-Ненецкий автономный округ 	89
Назарово 	Красноярский край 	24
Назрань 	Республика Ингушетия 	06
Называевск 	Омская область 	55
Нальчик 	Кабардино-Балкарская Республика 	07
Нариманов 	Астраханская область 	30
Наро-Фоминск 	Московская область 	50
Нарткала 	Кабардино-Балкарская Республика 	07
Нарьян-Мар 	Ненецкий автономный округ 	83
Находка 	Приморский край 	25
Невель 	Псковская область 	60
Невельск 	Сахалинская область 	65
Невинномысск 	Ставропольский край 	26
Невьянск 	Свердловская область 	66
Нелидово 	Тверская область 	69
Неман 	Калининградская область 	39
Нерехта 	Костромская область 	44
Нерчинск 	Забайкальский край 	75
Нерюнгри 	Республика Саха (Якутия) 	14
Нестеров 	Калининградская область 	39
Нефтегорск 	Самарская область 	63
Нефтекамск 	Республика Башкортостан 	02
Нефтекумск 	Ставропольский край 	26
Нефтеюганск 	ХМАО ЮГРА 	86
Нея 	Костромская область 	44
Нижневартовск 	ХМАО ЮГРА 	86
Нижнекамск 	Республика Татарстан 	16
Нижнеудинск 	Иркутская область 	38
Нижние Вязовые (ПГТ) 	Республика Татарстан 	16
Нижние Серги 	Свердловская область 	66
Нижний Ломов 	Пензенская область 	58
Нижний Новгород 	Нижегородская область 	52
Нижний Тагил 	Свердловская область 	66
Нижняя Мактама (ПГТ) 	Республика Татарстан 	16
Нижняя Салда 	Свердловская область 	66
Нижняя Тура 	Свердловская область 	66
Николаевск 	Волгоградская область 	34
Николаевск-на-Амуре 	Хабаровский край 	27
Никольск 	Вологодская область 	35
Никольск 	Пензенская область 	58
Никольское 	Ленинградская область 	47
Новая Ладога 	Ленинградская область 	47
Новая Ляда 	Тамбовская область 	68
Новая Ляля 	Свердловская область 	66
Новоалександровск 	Ставропольский край 	26
Новоалтайск 	Алтайский край 	22
Новоаннинский 	Волгоградская область 	34
Нововоронеж 	Воронежская область 	36
Новодвинск 	Архангельская область 	29
Новозыбков 	Брянская область 	32
Новокубанск 	Краснодарский край 	23
Новокузнецк 	Кемеровская область 	42
Новокуйбышевск 	Самарская область 	63
Новомичуринск 	Рязанская область 	62
Новомосковск 	Тульская область 	71
Новопавловск 	Ставропольский край 	26
Новопокровка 	Тамбовская область 	68
Новоржев 	Псковская область 	60
Новороссийск 	Краснодарский край 	23
Новосибирск 	Новосибирская область 	54
Новосиль 	Орловская область 	57
Новосокольники 	Псковская область 	60
Новотроицк 	Оренбургская область 	56
Новоузенск 	Саратовская область 	64
Новоульяновск 	Ульяновская область 	73
Новоуральск 	Свердловская область 	66
Новохопёрск 	Воронежская область 	36
Новочебоксарск 	Чувашская Республика 	21
Новочеркасск 	Ростовская область 	61
Новошахтинск 	Ростовская область 	61
Новый Оскол 	Белгородская область 	31
Новый Уренгой 	Ямало-Ненецкий автономный округ 	89
Ногинск 	Московская область 	50
Ногир 	Республика Северная Осетия - Алания 	15
Нолинск 	Кировская область 	43
Норильск 	Красноярский край 	24
Ноябрьск 	Ямало-Ненецкий автономный округ 	89
Нурлат 	Республика Татарстан 	16
Нытва 	Пермский край 	59
Нюрба 	Республика Саха (Якутия) 	14
Нягань 	ХМАО ЮГРА 	86
Нязепетровск 	Челябинская область 	74
Няндома 	Архангельская область 	29
О
Облучье 	Еврейская автономная область 	79
Обнинск 	Калужская область 	40
Обозерский 	Архангельская область 	29
Обоянь 	Курская область 	46
Обь 	Новосибирская область 	54
Одинцово 	Московская область 	50
Озёрный (ПГТ) 	Смоленская область 	67
Озёрск 	Калининградская область 	39
Озёрск 	Челябинская область 	74
Озёры 	Московская область 	50
Ойсхара (ПГТ) 	Чеченская Республика 	20
Оксовский 	Архангельская область 	29
Октябрьск 	Самарская область 	63
Октябрьский 	Республика Башкортостан 	02
Октябрьский 	Архангельская область 	29
Октябрьское 	Республика Северная Осетия - Алания 	15
Октябрьское 	Автономная Республика Крым 	82
Окуловка 	Новгородская область 	53
Олёкминск 	Республика Саха (Якутия) 	14
Оленегорск 	Мурманская область 	51
Олонец 	Республика Карелия 	10
Омск 	Омская область 	55
Омутнинск 	Кировская область 	43
Онега 	Архангельская область 	29
Опочка 	Псковская область 	60
Орёл 	Орловская область 	57
Оренбург 	Оренбургская область 	56
Орехово-Зуево 	Московская область 	50
Орлов 	Кировская область 	43
Орск 	Оренбургская область 	56
Оса 	Пермский край 	59
Осинники 	Кемеровская область 	42
Осташков 	Тверская область 	69
Остров 	Псковская область 	60
Островной 	Мурманская область 	51
Острогожск 	Воронежская область 	36
Отрадное 	Ленинградская область 	47
Отрадный 	Самарская область 	63
Оха 	Сахалинская область 	65
Оханск 	Пермский край 	59
Очёр 	Пермский край 	59
П
Павлово 	Нижегородская область 	52
Павловск 	Воронежская область 	36
Павловский Посад 	Московская область 	50
Павлодольская 	Республика Северная Осетия - Алания 	15
Палкино 	Псковская область 	60
Палласовка 	Волгоградская область 	34
Партизанск 	Приморский край 	25
Пачелма (ПГТ) 	Пензенская область 	58
Певек 	Чукотский автономный округ 	87
Пенза 	Пензенская область 	58
Первомайск 	Нижегородская область 	52
Первомайский 	Тамбовская область 	68
Первомайское 	Республика Карачаево-Черкессия 	09
Первоуральск 	Свердловская область 	66
Перевоз 	Нижегородская область 	52
Пересвет 	Московская область 	50
Переславль-Залесский 	Ярославская область 	76
Пермь 	Пермский край 	59
Пестово 	Новгородская область 	53
Петров Вал 	Волгоградская область 	34
Петровск 	Саратовская область 	64
Петровск-Забайкальский 	Забайкальский край 	75
Петрозаводск 	Республика Карелия 	10
Петропавловск-Камчатский 	Камчатский край 	41
Петухово 	Курганская область 	45
Петушки 	Владимирская область 	33
Печора 	Республика Коми 	11
Печоры 	Псковская область 	60
Пикалёво 	Ленинградская область 	47
Пионерский 	Калининградская область 	39
Питкяранта 	Республика Карелия 	10
Плавск 	Тульская область 	71
Пласт 	Челябинская область 	74
Плёс 	Ивановская область 	37
Плесецк 	Архангельская область 	29
Плюсса 	Псковская область 	60
Поворино 	Воронежская область 	36
Погар 	Брянская область 	32
Подольск 	Московская область 	50
Подпорожье 	Ленинградская область 	47
Покачи 	ХМАО ЮГРА 	86
Покров 	Владимирская область 	33
Покровск 	Республика Саха (Якутия) 	14
Полевской 	Свердловская область 	66
Полесск 	Калининградская область 	39
Полысаево 	Кемеровская область 	42
Полярные Зори 	Мурманская область 	51
Полярный 	Мурманская область 	51
Поронайск 	Сахалинская область 	65
Порхов 	Псковская область 	60
Похвистнево 	Самарская область 	63
Почеп 	Брянская область 	32
Починок 	Смоленская область 	67
Пошехонье 	Ярославская область 	76
Правдинск 	Калининградская область 	39
Преградная 	Республика Карачаево-Черкессия 	09
Пржевальское (ПГТ) 	Смоленская область 	67
Приводино 	Архангельская область 	29
Приволжск 	Ивановская область 	37
Приморск 	Калининградская область 	39
Приморск 	Ленинградская область 	47
Приморский 	Автономная Республика Крым 	82
Приморско-Ахтарск 	Краснодарский край 	23
Приозерск 	Ленинградская область 	47
Прокопьевск 	Кемеровская область 	42
Пролетарск 	Ростовская область 	61
Протвино 	Московская область 	50
Прохладный 	Кабардино-Балкарская Республика 	07
Псков 	Псковская область 	60
Псыж 	Республика Карачаево-Черкессия 	09
Пугачёв 	Саратовская область 	64
Пудож 	Республика Карелия 	10
Пуксоозеро 	Архангельская область 	29
Пустошка 	Псковская область 	60
Пучеж 	Ивановская область 	37
Пушкино 	Московская область 	50
Пушкинские Горы 	Псковская область 	60
Пущино 	Московская область 	50
Пыталово 	Псковская область 	60
Пыть-Ях 	ХМАО ЮГРА 	86
Пятигорск 	Ставропольский край 	26
Р
Радица-Крыловка 	Брянская область 	32
Радужный 	Владимирская область 	33
Радужный 	ХМАО ЮГРА 	86
Райчихинск 	Амурская область 	28
Рамасуха 	Брянская область 	32
Раменское 	Московская область 	50
Рассказово 	Тамбовская область 	68
Ревда 	Свердловская область 	66
Реж 	Свердловская область 	66
Реутов 	Московская область 	50
Ржакса 	Тамбовская область 	68
Ржев 	Тверская область 	69
Рогнедино 	Брянская область 	32
Родники 	Ивановская область 	37
Рославль 	Смоленская область 	67
Россошь 	Воронежская область 	36
Ростов 	Ярославская область 	76
Ростов-на-Дону 	Ростовская область 	61
Рошаль 	Московская область 	50
Ртищево 	Саратовская область 	64
Рубцовск 	Алтайский край 	22
Рудня 	Смоленская область 	67
Руза 	Московская область 	50
Рузаевка 	Республика Мордовия 	13
Рыбинск 	Ярославская область 	76
Рыбная Слобода (ПГТ) 	Республика Татарстан 	16
Рыбное 	Рязанская область 	62
Рыльск 	Курская область 	46
Ряжск 	Рязанская область 	62
Рязань 	Рязанская область 	62
С
Савинский 	Архангельская область 	29
Саки 	Автономная Республика Крым 	82
Салават 	Республика Башкортостан 	02
Салаир 	Кемеровская область 	42
Салехард 	Ямало-Ненецкий автономный округ 	89
Сальск 	Ростовская область 	61
Самара 	Самарская область 	63
Самодед 	Архангельская область 	29
Санкт-Петербург 	Город Санкт-Петербург 	78
Саранск 	Республика Мордовия 	13
Сарапул 	Удмуртская Республика 	18
Саратов 	Саратовская область 	64
Саров 	Нижегородская область 	52
Сасово 	Рязанская область 	62
Сатка 	Челябинская область 	74
Сафоново 	Смоленская область 	67
Саяногорск 	Республика Хакасия 	19
Саянск 	Иркутская область 	38
Светлогорск 	Калининградская область 	39
Светлоград 	Ставропольский край 	26
Светлый 	Калининградская область 	39
Светогорск 	Ленинградская область 	47
Свирск 	Иркутская область 	38
Свободный 	Амурская область 	28
Себеж 	Псковская область 	60
Севастополь 	Город Севастополь 	92
Северобайкальск 	Ресупблика Бурятия 	03
Северодвинск 	Архангельская область 	29
Северо-Курильск 	Сахалинская область 	65
Североморск 	Мурманская область 	51
Североонежск 	Архангельская область 	29
Североуральск 	Свердловская область 	66
Северск 	Томская область 	70
Севск 	Брянская область 	32
Сегежа 	Республика Карелия 	10
Сельцо 	Брянская область 	32
Семёнов 	Нижегородская область 	52
Семикаракорск 	Ростовская область 	61
Семилуки 	Воронежская область 	36
Сенгилей 	Ульяновская область 	73
Серафимович 	Волгоградская область 	34
Сергач 	Нижегородская область 	52
Сергиев Посад  	Московская область 	50
Сердобск 	Пензенская область 	58
Серов 	Свердловская область 	66
Серпухов 	Московская область 	50
Сертолово 	Ленинградская область 	47
Сибай 	Республика Башкортостан 	02
Сим 	Челябинская область 	74
Симферополь 	Автономная Республика Крым 	82
Сковородино 	Амурская область 	28
Скопин 	Рязанская область 	62
Славгород 	Алтайский край 	22
Славск 	Калининградская область 	39
Славянск-на-Кубани 	Краснодарский край 	23
Сланцы 	Ленинградская область 	47
Слободской 	Кировская область 	43
Слюдянка 	Иркутская область 	38
Смоленск 	Смоленская область 	67
Снежинск 	Челябинская область 	74
Снежногорск 	Мурманская область 	51
Собинка 	Владимирская область 	33
Советск 	Калининградская область 	39
Советск 	Кировская область 	43
Советск 	Тульская область 	71
Советская Гавань 	Хабаровский край 	27
Советский 	Автономная Республика Крым 	82
Советский 	ХМАО ЮГРА 	86
Сокол 	Вологодская область 	35
Солигалич 	Костромская область 	44
Соликамск 	Пермский край 	59
Солнечногорск 	Московская область 	50
Сольвычегодск 	Архангельская область 	29
Соль-Илецк 	Оренбургская область 	56
Сольцы 	Новгородская область 	53
Сорочинск 	Оренбургская область 	56
Сорск 	Республика Хакасия 	19
Сортавала 	Республика Карелия 	10
Сосенский 	Калужская область 	40
Сосновка 	Кировская область 	43
Сосновка 	Тамбовская область 	68
Сосновоборск 	Красноярский край 	24
Сосновоборск (ПГТ) 	Пензенская область 	58
Сосновый Бор 	Ленинградская область 	47
Сосновый Бор 	Псковская область 	60
Сосногорск 	Республика Коми 	11
Сочи 	Краснодарский край 	23
Спас-Деменск 	Калужская область 	40
Спас-Клепики 	Рязанская область 	62
Спасск 	Пензенская область 	58
Спасск-Дальний 	Приморский край 	25
Спасск-Рязанский 	Рязанская область 	62
Среднеколымск 	Республика Саха (Якутия) 	14
Среднеуральск 	Свердловская область 	66
Сретенск 	Забайкальский край 	75
Ставрополь 	Ставропольский край 	26
Старая Купавна 	Московская область 	50
Старая Русса 	Новгородская область 	53
Старица 	Тверская область 	69
Стародуб 	Брянская область 	32
Старый Крым 	Автономная Республика Крым 	82
Старый Оскол 	Белгородская область 	31
Старь 	Брянская область 	32
Стерлитамак 	Республика Башкортостан 	02
Сторожевая 	Республика Карачаево-Черкессия 	09
Стрежевой 	Томская область 	70
Строитель 	Белгородская область 	31
Струги Красные 	Псковская область 	60
Струнино 	Владимирская область 	33
Ступино 	Московская область 	50
Суворов 	Тульская область 	71
Судак 	Автономная Республика Крым 	82
Суджа 	Курская область 	46
Судогда 	Владимирская область 	33
Суздаль 	Владимирская область 	33
Суземка 	Брянская область 	32
Сунжа 	Республика Ингушетия 	06
Сунжа 	Республика Северная Осетия - Алания 	15
Суоярви 	Республика Карелия 	10
Сура (ПГТ) 	Пензенская область 	58
Сураж 	Брянская область 	32
Сургут 	ХМАО ЮГРА 	86
Суровикино 	Волгоградская область 	34
Сурск 	Пензенская область 	58
Сусуман 	Магаданская область 	49
Сухиничи 	Калужская область 	40
Сухой Лог 	Свердловская область 	66
Сызрань 	Самарская область 	63
Сыктывкар 	Республика Коми 	11
Сысерть 	Свердловская область 	66
Сычёвка 	Смоленская область 	67
Сясьстрой 	Ленинградская область 	47
Т
Тавда 	Свердловская область 	66
Таганрог 	Ростовская область 	61
Тайга 	Кемеровская область 	42
Тайшет 	Иркутская область 	38
Талдом 	Московская область 	50
Талица 	Свердловская область 	66
Тамала (ПГТ) 	Пензенская область 	58
Тамбов 	Тамбовская область 	68
Тара 	Омская область 	55
Тарко-Сале 	Ямало-Ненецкий автономный округ 	89
Таруса 	Калужская область 	40
Татарск 	Новосибирская область 	54
Таштагол 	Кемеровская область 	42
Тверь 	Тверская область 	69
Теберда 	Республика Карачаево-Черкессия 	09
Тейково 	Ивановская область 	37
Темников 	Республика Мордовия 	13
Темрюк 	Краснодарский край 	23
Тенишево (ПГТ) 	Республика Татарстан 	16
Терезе 	Республика Карачаево-Черкессия 	09
Терек 	Кабардино-Балкарская Республика 	07
Тетюши 	Республика Татарстан 	16
Тимашёвск 	Краснодарский край 	23
Тихвин 	Ленинградская область 	47
Тихорецк 	Краснодарский край 	23
Тлюстенхабль (ПГТ) 	Республика Адыгея 	01
Тобольск 	Тюменская область 	72
Тогучин 	Новосибирская область 	54
Токарёвка 	Тамбовская область 	68
Тольятти 	Самарская область 	63
Томари 	Сахалинская область 	65
Томмот 	Республика Саха (Якутия) 	14
Томск 	Томская область 	70
Топки 	Кемеровская область 	42
Торжок 	Тверская область 	69
Торопец 	Тверская область 	69
Тосно 	Ленинградская область 	47
Тотьма 	Вологодская область 	35
Трёхгорный 	Челябинская область 	74
Троицк 	Челябинская область 	74
Трубчевск 	Брянская область 	32
Туапсе 	Краснодарский край 	23
Туймазы 	Республика Башкортостан 	02
Тула 	Тульская область 	71
Тулун 	Иркутская область 	38
Туран 	Республика Тыва 	17
Туринск 	Свердловская область 	66
Тутаев 	Ярославская область 	76
Тында 	Амурская область 	28
Тырныауз 	Кабардино-Балкарская Республика 	07
Тюкалинск 	Омская область 	55
Тюмень 	Тюменская область 	72
У
Уварово 	Тамбовская область 	68
Углегорск 	Сахалинская область 	65
Углич 	Ярославская область 	76
Удачный 	Республика Саха (Якутия) 	14
Удомля 	Тверская область 	69
Ужур 	Красноярский край 	24
Узловая 	Тульская область 	71
Улан-Удэ 	Ресупблика Бурятия 	03
Ульяновск 	Ульяновская область 	73
Умёт 	Тамбовская область 	68
Унеча 	Брянская область 	32
Урай 	ХМАО ЮГРА 	86
Урдома 	Архангельская область 	29
Урень 	Нижегородская область 	52
Уржум 	Кировская область 	43
Урус-Мартан 	Чеченская Республика 	20
Уруссу (ПГТ) 	Республика Татарстан 	16
Урюпинск 	Волгоградская область 	34
Усвяты 	Псковская область 	60
Усинск 	Республика Коми 	11
Усмань 	Липецкая область 	48
Усолье 	Пермский край 	59
Усолье-Сибирское 	Иркутская область 	38
Уссурийск 	Приморский край 	25
Усть-Абакан (ПГТ) 	Республика Хакасия 	19
Усть-Джегута 	Республика Карачаево-Черкессия 	09
Усть-Илимск 	Иркутская область 	38
Усть-Катав 	Челябинская область 	74
Усть-Кут 	Иркутская область 	38
Усть-Лабинск 	Краснодарский край 	23
Устюжна 	Вологодская область 	35
Уфа 	Республика Башкортостан 	02
Ухта 	Республика Коми 	11
Учалы 	Республика Башкортостан 	02
Учкекен 	Республика Карачаево-Черкессия 	09
Уяр 	Красноярский край 	24
Ф
Фатеж 	Курская область 	46
Феодосия 	Автономная Республика Крым 	82
Фокино 	Приморский край 	25
Фокино 	Брянская область 	32
Фролово 	Волгоградская область 	34
Фрязино 	Московская область 	50
Фурманов 	Ивановская область 	37
Х
Хабаровск 	Хабаровский край 	27
Хабез 	Республика Карачаево-Черкессия 	09
Хадыженск 	Краснодарский край 	23
Ханты-Мансийск 	ХМАО ЮГРА 	86
Харабали 	Астраханская область 	30
Харовск 	Вологодская область 	35
Хасавюрт 	Республика Дагестан 	05
Хвалынск 	Саратовская область 	64
Хилок 	Забайкальский край 	75
Химки 	Московская область 	50
Хиславичи (ПГТ) 	Смоленская область 	67
Холм 	Новгородская область 	53
Холм-Жирковский (ПГТ) 	Смоленская область 	67
Холмск 	Сахалинская область 	65
Хотьково 	Московская область 	50
Ц
Цивильск 	Чувашская Республика 	21
Цимлянск 	Ростовская область 	61
Циолковский 	Амурская область 	28
Ч
Чаадаевка (ПГТ) 	Пензенская область 	58
Чадан 	Республика Тыва 	17
Чайковский 	Пермский край 	59
Чапаевск 	Самарская область 	63
Чапаевское 	Республика Карачаево-Черкессия 	09
Чаплыгин 	Липецкая область 	48
Чебаркуль 	Челябинская область 	74
Чебоксары 	Чувашская Республика 	21
Чегем 	Кабардино-Балкарская Республика 	07
Чекалин 	Тульская область 	71
Челябинск 	Челябинская область 	74
Чердынь 	Пермский край 	59
Черемхово 	Иркутская область 	38
Черепаново 	Новосибирская область 	54
Череповец 	Вологодская область 	35
Черкесск 	Республика Карачаево-Черкессия 	09
Чермен 	Республика Северная Осетия - Алания 	15
Чёрмоз 	Пермский край 	59
Черноголовка 	Московская область 	50
Черногорск 	Республика Хакасия 	19
Черноморское 	Автономная Республика Крым 	82
Чернушка 	Пермский край 	59
Черняховск 	Калининградская область 	39
Чехов 	Московская область 	50
Чикола 	Республика Северная Осетия - Алания 	15
Чири-Юрт (ПГТ) 	Чеченская Республика 	20
Чистополь 	Республика Татарстан 	16
Чита 	Забайкальский край 	75
Чкаловск 	Нижегородская область 	52
Чудово 	Новгородская область 	53
Чулым 	Новосибирская область 	54
Чусовой 	Пермский край 	59
Чухлома 	Костромская область 	44
Ш
Шагонар 	Республика Тыва 	17
Шадринск 	Курганская область 	45
Шали 	Чеченская Республика 	20
Шарыпово 	Красноярский край 	24
Шарья 	Костромская область 	44
Шатура 	Московская область 	50
Шахты 	Ростовская область 	61
Шахунья 	Нижегородская область 	52
Шацк 	Рязанская область 	62
Шебекино 	Белгородская область 	31
Шелехов 	Иркутская область 	38
Шемышейка (ПГТ) 	Пензенская область 	58
Шенкурск 	Архангельская область 	29
Шилка 	Забайкальский край 	75
Шимановск 	Амурская область 	28
Шипицыно 	Архангельская область 	29
Шиханы 	Саратовская область 	64
Шлиссельбург 	Ленинградская область 	47
Шумерля 	Чувашская Республика 	21
Шумиха 	Курганская область 	45
Шумячи (ПГТ) 	Смоленская область 	67
Шуя 	Ивановская область 	37
Щ
Щёкино 	Тульская область 	71
Щёлкино 	Автономная Республика Крым 	82
Щёлково 	Московская область 	50
Щигры 	Курская область 	46
Щучье 	Курганская область 	45
Э
Электрогорск 	Московская область 	50
Электросталь 	Московская область 	50
Электроугли 	Московская область 	50
Элиста 	Республика Калмыкия 	08
Эльхотово 	Республика Северная Осетия - Алания 	15
Энгельс 	Саратовская область 	64
Энем (ПГТ) 	Республика Адыгея 	01
Эртиль 	Воронежская область 	36
Ю
Югорск 	ХМАО ЮГРА 	86
Южа 	Ивановская область 	37
Южно-Сахалинск 	Сахалинская область 	65
Южно-Сухокумск 	Республика Дагестан 	05
Южноуральск 	Челябинская область 	74
Юрга 	Кемеровская область 	42
Юрьевец 	Ивановская область 	37
Юрьев-Польский 	Владимирская область 	33
Юрюзань 	Челябинская область 	74
Юхнов 	Калужская область 	40
Я
Яблоновский (ПГТ) 	Республика Адыгея 	01
Ядрин 	Чувашская Республика 	21
Якутск 	Республика Саха (Якутия) 	14
Ялта 	Автономная Республика Крым 	82
Ялуторовск 	Тюменская область 	72
Янаул 	Республика Башкортостан 	02
Яранск 	Кировская область 	43
Яровое 	Алтайский край 	22
Ярославль 	Ярославская область 	76
Ярцево 	Смоленская область 	67
Ясногорск 	Тульская область 	71
Ясный 	Оренбургская область 	56
Яхрома 	Московская область